ar_EG.UTF-8	ar_EG@platform=solaris,yesno=short,copy_ctype=CTYPE.UTF-8
ar_SA.UTF-8	ar_SA@platform=solaris,yesno=short,copy_ctype=CTYPE.UTF-8
bg_BG.UTF-8	bg_BG@platform=solaris,yesno=short,copy_ctype=CTYPE.UTF-8
ca_ES.UTF-8	ca_ES@platform=solaris,yesno=short,copy_ctype=CTYPE.UTF-8
cs_CZ.UTF-8	cs_CZ@platform=solaris,yesno=short,copy_ctype=CTYPE.UTF-8
da_DK.UTF-8	da_DK@platform=solaris,yesno=short,copy_ctype=CTYPE.UTF-8
de_AT.UTF-8	de_AT@platform=solaris,yesno=short,copy_ctype=CTYPE.UTF-8
de_CH.UTF-8	de_CH@platform=solaris,yesno=short,copy_ctype=CTYPE.UTF-8
de_DE.UTF-8	de_DE@platform=solaris,yesno=short,copy_ctype=CTYPE.UTF-8
de_LU.UTF-8	de_LU@platform=solaris,yesno=short,copy_ctype=CTYPE.UTF-8
el_CY.UTF-8	el_CY@platform=solaris,yesno=short,copy_ctype=CTYPE.UTF-8
el_GR.UTF-8	el_GR@platform=solaris,yesno=short,copy_ctype=CTYPE.UTF-8
en_AU.UTF-8	en_AU@platform=solaris,yesno=short,copy_ctype=CTYPE.UTF-8
en_CA.UTF-8	en_CA@platform=solaris,yesno=short,copy_ctype=CTYPE.UTF-8
en_GB.UTF-8	en_GB@platform=solaris,yesno=short,copy_ctype=CTYPE.UTF-8
en_IE.UTF-8	en_IE@platform=solaris,yesno=short,copy_ctype=CTYPE.UTF-8
en_MT.UTF-8	en_MT@platform=solaris,yesno=short,copy_ctype=CTYPE.UTF-8
en_NZ.UTF-8	en_NZ@platform=solaris,yesno=short,copy_ctype=CTYPE.UTF-8
es_AR.UTF-8	es_AR@platform=solaris,yesno=short,copy_ctype=CTYPE.UTF-8
es_BO.UTF-8	es_BO@platform=solaris,yesno=short,copy_ctype=CTYPE.UTF-8
es_CL.UTF-8	es_CL@platform=solaris,yesno=short,copy_ctype=CTYPE.UTF-8
es_CO.UTF-8	es_CO@platform=solaris,yesno=short,copy_ctype=CTYPE.UTF-8
es_CR.UTF-8	es_CR@platform=solaris,yesno=short,copy_ctype=CTYPE.UTF-8
es_EC.UTF-8	es_EC@platform=solaris,yesno=short,copy_ctype=CTYPE.UTF-8
es_ES.UTF-8	es_ES@platform=solaris,yesno=short,copy_ctype=CTYPE.UTF-8
es_GT.UTF-8	es_GT@platform=solaris,yesno=short,copy_ctype=CTYPE.UTF-8
es_MX.UTF-8	es_MX@platform=solaris,yesno=short,copy_ctype=CTYPE.UTF-8
es_NI.UTF-8	es_NI@platform=solaris,yesno=short,copy_ctype=CTYPE.UTF-8
es_PA.UTF-8	es_PA@platform=solaris,yesno=short,copy_ctype=CTYPE.UTF-8
es_PE.UTF-8	es_PE@platform=solaris,yesno=short,copy_ctype=CTYPE.UTF-8
es_PY.UTF-8	es_PY@platform=solaris,yesno=short,copy_ctype=CTYPE.UTF-8
es_SV.UTF-8	es_SV@platform=solaris,yesno=short,copy_ctype=CTYPE.UTF-8
es_UY.UTF-8	es_UY@platform=solaris,yesno=short,copy_ctype=CTYPE.UTF-8
es_VE.UTF-8	es_VE@platform=solaris,yesno=short,copy_ctype=CTYPE.UTF-8
et_EE.UTF-8	et_EE@platform=solaris,yesno=short,copy_ctype=CTYPE.UTF-8
fi_FI.UTF-8	fi_FI@platform=solaris,yesno=short,copy_ctype=CTYPE.UTF-8
fr_BE.UTF-8	fr_BE@platform=solaris,yesno=short,copy_ctype=CTYPE.UTF-8
fr_CA.UTF-8	fr_CA@platform=solaris,yesno=short,copy_ctype=CTYPE.UTF-8
fr_CH.UTF-8	fr_CH@platform=solaris,yesno=short,copy_ctype=CTYPE.UTF-8
fr_FR.UTF-8	fr_FR@platform=solaris,yesno=short,copy_ctype=CTYPE.UTF-8
fr_LU.UTF-8	fr_LU@platform=solaris,yesno=short,copy_ctype=CTYPE.UTF-8
he_IL.UTF-8	he_IL@platform=solaris,yesno=short,copy_ctype=CTYPE.UTF-8
hr_HR.UTF-8	hr_HR@platform=solaris,yesno=short,copy_ctype=CTYPE.UTF-8
hu_HU.UTF-8	hu_HU@platform=solaris,yesno=short,copy_ctype=CTYPE.UTF-8
id_ID.UTF-8	id_ID@platform=solaris,yesno=short,copy_ctype=CTYPE.UTF-8
is_IS.UTF-8	is_IS@platform=solaris,yesno=short,copy_ctype=CTYPE.UTF-8
it_IT.UTF-8	it_IT@platform=solaris,yesno=short,copy_ctype=CTYPE.UTF-8
lt_LT.UTF-8	lt_LT@platform=solaris,yesno=short,copy_ctype=CTYPE.UTF-8
lv_LV.UTF-8	lv_LV@platform=solaris,yesno=short,copy_ctype=CTYPE.UTF-8
mk_MK.UTF-8	mk_MK@platform=solaris,yesno=short,copy_ctype=CTYPE.UTF-8
ms_MY.UTF-8	ms_MY@platform=solaris,yesno=short,copy_ctype=CTYPE.UTF-8
mt_MT.UTF-8	mt_MT@platform=solaris,yesno=short,copy_ctype=CTYPE.UTF-8
nb_NO.UTF-8	nb_NO@platform=solaris,yesno=short,copy_ctype=CTYPE.UTF-8
nl_BE.UTF-8	nl_BE@platform=solaris,yesno=short,copy_ctype=CTYPE.UTF-8
nl_NL.UTF-8	nl_NL@platform=solaris,yesno=short,copy_ctype=CTYPE.UTF-8
nn_NO.UTF-8	nn_NO@platform=solaris,yesno=short,copy_ctype=CTYPE.UTF-8
pl_PL.UTF-8	pl_PL@platform=solaris,yesno=short,copy_ctype=CTYPE.UTF-8
pt_BR.UTF-8	pt_BR@platform=solaris,yesno=short,copy_ctype=CTYPE.UTF-8
pt_PT.UTF-8	pt_PT@platform=solaris,yesno=short,copy_ctype=CTYPE.UTF-8
ro_RO.UTF-8	ro_RO@platform=solaris,yesno=short,copy_ctype=CTYPE.UTF-8
ru_RU.UTF-8	ru_RU@platform=solaris,yesno=short,copy_ctype=CTYPE.UTF-8
sk_SK.UTF-8	sk_SK@platform=solaris,yesno=short,copy_ctype=CTYPE.UTF-8
sl_SI.UTF-8	sl_SI@platform=solaris,yesno=short,copy_ctype=CTYPE.UTF-8
sq_AL.UTF-8	sq_AL@platform=solaris,yesno=short,copy_ctype=CTYPE.UTF-8
sv_SE.UTF-8	sv_SE@platform=solaris,yesno=short,copy_ctype=CTYPE.UTF-8
tr_TR.UTF-8	tr_TR@platform=solaris,yesno=short,copy_ctype=CTYPE.UTF-8
uk_UA.UTF-8	uk_UA@platform=solaris,yesno=short,copy_ctype=CTYPE.UTF-8
vi_VN.UTF-8	vi_VN@platform=solaris,yesno=short,copy_ctype=CTYPE.UTF-8
